,,배달의민족,키오스크,챗봇,현금,총합,비율
샐러드,이너프,1672,278,0,132,2082,22 %
샐러드,연어,991,211,0,179,1381,14 %
샐러드,숲속,1113,203,0,165,1481,16 %
샐러드,목살,1687,385,0,251,2323,25 %
샐러드,닭가슴살,1395,354,0,233,1982,21 %
메인추가,연어,171,9,0,60,240,19 %
메인추가,숲속,226,39,0,69,334,26 %
메인추가,목살,262,66,0,57,385,30 %
메인추가,닭가슴살,198,36,0,51,285,22 %
드레싱,오리엔탈,2352,527,0,310,3189,40 %
드레싱,발사믹,1419,416,0,162,1997,25 %
드레싱,렌치,2085,354,0,322,2761,34 %
extra,고구마,1255,310,0,201,1766,98 %
extra,계란,0,27,0,0,27,1 %
